//MAP CONVERTED BY dmm2tgm.py THIS HEADER COMMENT PREVENTS RECONVERSION, DO NOT REMOVE
"a" = (
/turf/closed/wall/mineral/titanium/survival/nodiagonal,
/area/misc/survivalpod)
"b" = (
/obj/structure/window/reinforced/spawner/directional/east,
/turf/open/floor/pod,
/area/misc/survivalpod)
"c" = (
/obj/machinery/nanite_programmer,
/obj/effect/turf_decal/trimline/purple/line{
	dir = 9
	},
/turf/open/floor/pod,
/area/misc/survivalpod)
"d" = (
/obj/structure/bed/pod{
	dir = 1
	},
/obj/item/bedsheet/cosmos{
	dir = 1
	},
/turf/open/floor/pod,
/area/misc/survivalpod)
"e" = (
/obj/effect/turf_decal/trimline/blue/filled/corner{
	dir = 1
	},
/turf/open/floor/pod,
/area/misc/survivalpod)
"f" = (
/obj/machinery/rnd/production/protolathe/department/science,
/turf/open/floor/pod,
/area/misc/survivalpod)
"g" = (
/obj/effect/turf_decal/tile/blue/fourcorners,
/turf/open/floor/pod,
/area/misc/survivalpod)
"h" = (
/obj/machinery/microwave,
/obj/structure/table/glass,
/turf/open/floor/pod,
/area/misc/survivalpod)
"i" = (
/obj/effect/turf_decal/trimline/purple/line{
	dir = 1
	},
/turf/open/floor/pod,
/area/misc/survivalpod)
"j" = (
/obj/structure/window/reinforced/spawner/directional/south,
/turf/open/floor/pod,
/area/misc/survivalpod)
"k" = (
/obj/machinery/light_switch/directional/south,
/turf/open/floor/pod,
/area/misc/survivalpod)
"l" = (
/obj/machinery/stasis/survival_pod,
/turf/open/floor/pod,
/area/misc/survivalpod)
"o" = (
/obj/effect/turf_decal/trimline/purple/line,
/turf/open/floor/pod,
/area/misc/survivalpod)
"p" = (
/obj/machinery/rnd/experimentor,
/turf/open/floor/engine,
/area/misc/survivalpod)
"q" = (
/obj/effect/turf_decal/tile/blue/fourcorners,
/obj/item/surgery_tray/full/advanced,
/turf/open/floor/pod,
/area/misc/survivalpod)
"t" = (
/obj/structure/bed/pod{
	dir = 1
	},
/obj/item/bedsheet/cosmos{
	dir = 1
	},
/obj/item/toy/plush/beefplushie,
/turf/open/floor/pod,
/area/misc/survivalpod)
"u" = (
/obj/machinery/door/window/brigdoor/left/directional/south,
/turf/open/floor/pod,
/area/misc/survivalpod)
"w" = (
/obj/effect/turf_decal/stripes/line{
	dir = 8
	},
/turf/open/floor/engine,
/area/misc/survivalpod)
"x" = (
/obj/machinery/vending/wallmed/directional/west,
/turf/open/floor/pod,
/area/misc/survivalpod)
"y" = (
/obj/machinery/computer/crew{
	dir = 4
	},
/obj/effect/turf_decal/trimline/blue/filled/corner{
	dir = 4
	},
/turf/open/floor/pod,
/area/misc/survivalpod)
"z" = (
/obj/effect/turf_decal/trimline/purple/line{
	dir = 4
	},
/turf/open/floor/pod,
/area/misc/survivalpod)
"A" = (
/obj/machinery/nanite_chamber,
/obj/effect/turf_decal/trimline/purple/line{
	dir = 5
	},
/turf/open/floor/pod,
/area/misc/survivalpod)
"B" = (
/obj/structure/table/optable,
/turf/open/floor/pod,
/area/misc/survivalpod)
"C" = (
/obj/structure/closet/wardrobe/pjs,
/obj/item/clothing/suit/hooded/onesie/beefman,
/turf/open/floor/pod,
/area/misc/survivalpod)
"D" = (
/obj/structure/table/glass,
/obj/effect/spawner/random/food_or_drink/donkpockets,
/obj/machinery/light/dim/directional/east,
/turf/open/floor/pod,
/area/misc/survivalpod)
"E" = (
/obj/effect/turf_decal/trimline/blue/filled/corner{
	dir = 8
	},
/turf/open/floor/pod,
/area/misc/survivalpod)
"F" = (
/obj/structure/toilet{
	dir = 4
	},
/turf/open/floor/pod,
/area/misc/survivalpod)
"G" = (
/turf/open/floor/engine,
/area/misc/survivalpod)
"I" = (
/obj/structure/sign/poster/official/nanotrasen_logo,
/turf/closed/wall/mineral/titanium/survival/nodiagonal,
/area/misc/survivalpod)
"J" = (
/obj/structure/sign/directions/dorms/directional/north,
/obj/machinery/shower/directional/south,
/obj/structure/curtain,
/turf/open/floor/pod,
/area/misc/survivalpod)
"L" = (
/obj/structure/chair/plastic,
/turf/open/floor/pod,
/area/misc/survivalpod)
"M" = (
/turf/open/floor/pod,
/area/misc/survivalpod)
"N" = (
/obj/effect/turf_decal/tile/blue/fourcorners,
/obj/machinery/light/directional/east,
/turf/open/floor/pod,
/area/misc/survivalpod)
"O" = (
/obj/machinery/stasis/survival_pod,
/obj/effect/turf_decal/trimline/blue/filled/corner,
/turf/open/floor/pod,
/area/misc/survivalpod)
"P" = (
/obj/effect/turf_decal/stripes/line{
	dir = 1
	},
/turf/open/floor/engine,
/area/misc/survivalpod)
"Q" = (
/obj/machinery/door/airlock/survival_pod/glass,
/turf/open/floor/pod,
/area/misc/survivalpod)
"R" = (
/obj/machinery/nanite_program_hub,
/obj/effect/turf_decal/trimline/purple/line{
	dir = 10
	},
/turf/open/floor/pod,
/area/misc/survivalpod)
"S" = (
/obj/machinery/rnd/production/circuit_imprinter/department/science,
/obj/structure/sign/departments/med_alt/directional/north,
/turf/open/floor/pod,
/area/misc/survivalpod)
"T" = (
/obj/machinery/light/directional/south,
/obj/machinery/computer/rdconsole{
	dir = 1
	},
/obj/effect/turf_decal/trimline/purple/line{
	dir = 6
	},
/turf/open/floor/pod,
/area/misc/survivalpod)
"V" = (
/obj/machinery/light/directional/east,
/obj/structure/window/reinforced/spawner/directional/south,
/turf/open/floor/pod,
/area/misc/survivalpod)
"W" = (
/obj/structure/sign/departments/nanites/directional/west,
/obj/effect/turf_decal/trimline/purple/line{
	dir = 8
	},
/turf/open/floor/pod,
/area/misc/survivalpod)
"Y" = (
/obj/effect/turf_decal/stripes/line{
	dir = 9
	},
/turf/open/floor/engine,
/area/misc/survivalpod)
"Z" = (
/obj/structure/table/glass,
/obj/item/storage/medkit,
/obj/item/storage/medkit/o2,
/turf/open/floor/pod,
/area/misc/survivalpod)

(1,1,1) = {"
a
a
a
a
a
a
a
a
a
a
a
"}
(2,1,1) = {"
a
t
M
d
a
F
a
c
W
R
a
"}
(3,1,1) = {"
a
M
M
k
a
Q
a
i
M
o
a
"}
(4,1,1) = {"
a
M
M
M
Q
M
M
A
z
T
a
"}
(5,1,1) = {"
a
h
D
C
a
J
M
M
M
M
I
"}
(6,1,1) = {"
a
a
a
a
a
a
f
M
M
M
Q
"}
(7,1,1) = {"
I
l
x
O
y
a
S
M
b
b
I
"}
(8,1,1) = {"
Q
M
g
E
e
Q
M
j
Y
w
a
"}
(9,1,1) = {"
I
g
g
q
M
a
M
u
P
p
a
"}
(10,1,1) = {"
a
Z
N
L
B
a
M
V
P
G
a
"}
(11,1,1) = {"
a
a
a
a
a
a
a
a
a
a
a
"}
